[
  ["#", "#", "#", "#", "#", "#", "#"],
  ["#", "S", "_", ">", ".", ".", "#"],
  ["#", "v", "_", "X", ".", ".", "#"],
  ["#", "~", "_", "#", "<", ".", "#"],
  ["#", "~", "_", "#", ".", ".", "#"],
  ["#", "@", "^", "#", ".", "E", "#"],
  ["#", "#", "#", "#", "#", "#", "#"]
]